ssssssssss
ss######ss
s##ssss#ss
s#.@$ss#ss
s###s$.#ss
s#.##$s#ss
s#s#s.s##s
s#$s*$$.#s
s#sss.ss#s
s########s
ssssssssss