ssssssssss
sss#####ss
s###sss#ss
s#.@$ss#ss
s###s$.#ss
s#.##$s#ss
s#s#s.s##s
s#$s*$$.#s
s#sss.ss#s
s########s
ssssssssss