ssssssssss
s######sss
s#.#ss##ss
s#...ss##s
s#s#*sss#s
s#s$@#ss#s
s##s$s$s#s
ss#$s$s##s
ss#sss##ss
ss#####sss
ssssssssss